F 220,100,0
C 225,30,0
NO ./path_to_the_north_texture

EA ./path_to_the_east_texture
SO ./path_to_the_south_texture


WE ./path_to_the_west_texture

111111111
100000001
100000001
110000001
111000001
100000001
100100001
111111111
